WE ./textures/64/lava-wall.xpm
NO ./textures/64/moss-wall.xpm
SO ./textures/wallS.xpm

EA ./textures/64/skull-wall.xpm


F 100,100,100
C 0,0,100



111111111111111111111111111
1000000000011000000000011111111111
100100000000000000D00000000000000*
111111000100001110001111111111111
1011000000001N00H0T0000111111111
100000000011000000010111111111
11111D111111111D11100000D00001
11110011111111011100100100011
11000000000001011100000010001
1000000000000000110000010001
10000000000000000000000010001
110000011101010110000000000111
1111111111111111111111111111111