WE ./textures/64/EW.xpm
NO ./textures/64/nord.xpm

SO ./textures/64/sud.xpm

EA ./textures/64/EW.xpm
F 30,200,70

C 0,0,150






11111111111111111111111111
10000000000110000000000001
1011000001110000000000001
1001000000000000000000001
111111111011000001110000011111111
100000000011000001110111111111111
11110111111111011100000010001
11110111111111011101010010001
11000000110101011100000010001
10000000000000001100000100011
100000000000N00001101010010001
1100000111010101111101111000111
11110111 1110101 101111010001
111111111 1111111111111111111
