WE ./textures/64/lava-wall.xpm
NO ./textures/64/moss-wall.xpm
SO ./textures/wallS.xpm

EA ./textures/64/skull-wall.xpm


F 100,100,100
C 0,0,100



11111111111111111111111111
100000000001100000000000W1
1011000001110000000000001
1001000000000000000000D01
111111111011000001110000011111111
100000000011000001110111111111111
11110111111111011100000010001
11110111111111011101010D010001
11000000000001011100000010001
10000000000000001100000100011
10000000000000000110110010001
1100000111010101111101111000111
11110111 1110101 101111010001
111111111 1111111111111111111
