WE ./textures/64/lava-wall.xpm
NO ./textures/64/moss-wall.xpm
SO ./textures/wallS.xpm

EA ./textures/64/skull-wall.xpm


F 100,100,100
C 0,0,100



111111111111111111111111111
10000000000110000000000001
1011000000010N00000000001111111
100100000000000000D0000H00T000*
1111110001000001110000011111111
100000000011000000010111111111
11111D111111111D11100000010001
111101111111110111010100100011
11000000000001011100000010001
10000000000000001100000010001
10000000000000000D010D0010001
1100000111010101111D11111000111
1111111111111111111111111111111