WE ./textures/64/lava-wall.xpm
NO ./textures/64/moss-wall.xpm
SO ./textures/wallS.xpm

EA ./textures/64/skull-wall.xpm


F 100,100,100
C 0,0,100



11111111111111111111111111
1TH00000000110000000000001
1011000000010000000000001111111
100100000000000000D000S000001
1111110001000001110000011111111
100000000011000000010111111111
11111D111111111D111000000100011
11110111111111011101010010001
11000000000001011100000010001
10000000000000001100000010001
10000000000000000D010D0010001
1100000111010101111D11111000111
1111111111111111111111111111111