WE ./textures/64/lava-wall.xpm
NO ./textures/64/moss-wall.xpm
SO ./textures/wallS.xpm

EA ./textures/64/skull-wall.xpm


F 100,100,100
C 0,0,100



1111111111111111111111111111
10000000000110000000000001
1011000000010000000000001111111
10010000000000000D000S0000000001
11111100001000001110000011111111
100000000011000000010111111111
11111D111111111D11100000010001
1111011111111101110101001000
11000000000001011100000010001
10000000000000001100000100011
100000000000000000D010D0010001
1100000111010101111D11111000111
1111111111111111111111111111111